# WiReach keywords #

WIFI_PRO_V3	KEYWORD2
_errorCode	KEYWORD2
_rtt	KEYWORD2
_value	KEYWORD2
_ip	KEYWORD2
_gw	KEYWORD2
_tcp_session_id	KEYWORD2
_channel	KEYWORD2
_snr	KEYWORD2
_buffer	KEYWORD2
_length	KEYWORD2
_netmask	KEYWORD2
_dns1	KEYWORD2
_dns2	KEYWORD2
_essid	KEYWORD2
_firmwareVersion	KEYWORD2
_httpSessionId	KEYWORD2
resetValues	KEYWORD2
configureMode	KEYWORD2
configureStation	KEYWORD2
configureAp	KEYWORD2
configureApSettings	KEYWORD2
connect	KEYWORD2
softReset	KEYWORD2
isConnected	KEYWORD2
isConnectedMultiple	KEYWORD2
ping	KEYWORD2
printErrorCode	KEYWORD2
printSockets	KEYWORD2
scan	KEYWORD2
setIP	KEYWORD2
getIP	KEYWORD2
setDNS	KEYWORD2
setGateway	KEYWORD2
setNetmask	KEYWORD2
setURL	KEYWORD2
getURL	KEYWORD2
post	KEYWORD2
sendFrameToMeshlium	KEYWORD2
tcpSend	KEYWORD2
tcpReceive	KEYWORD2
tcpClose	KEYWORD2
tcpSetClient	KEYWORD2
tcpSetServer	KEYWORD2
tcpWaitClientConnection	KEYWORD2
tcpCloseAllSockets	KEYWORD2
setUDP	KEYWORD2
closeDownSockets	KEYWORD2
getAllSocketStatus	KEYWORD2
getSocketStatus	KEYWORD2
setTimeServer	KEYWORD2
timeActivationFlag	KEYWORD2
setGMT	KEYWORD2
setTimeFromWIFI	KEYWORD2
requestOTA	KEYWORD2
roamingMode	KEYWORD2
getGateway	KEYWORD2
getNetmask	KEYWORD2
getDNS	KEYWORD2
getESSID	KEYWORD2
setCA	KEYWORD2
reportStatusComplete	KEYWORD2
setScanInterval	KEYWORD2
setLowThreshold	KEYWORD2
setHighThreshold	KEYWORD2
setWorkingMode	KEYWORD2
setServerPoolSize	KEYWORD2
socket	KEYWORD2
reportStatus	KEYWORD2
reportStatus4	KEYWORD2
parseResponse	KEYWORD2
parseResponse2	KEYWORD2
parseResponse3	KEYWORD2
parseResponse4	KEYWORD2
parseResponse5	KEYWORD2
getResponseValue	KEYWORD2
getResponseValue2	KEYWORD2
getResponseValue3	KEYWORD2
getResponseValue4	KEYWORD2
getResponseValue5	KEYWORD2
changeBaudRate	KEYWORD2
userAbort	KEYWORD2
socketAbort	KEYWORD2
setContentType	KEYWORD2
reportStatus8	KEYWORD2
httpConfiguration	KEYWORD2
getFirmwareVersion	KEYWORD2
sslHandshake	KEYWORD2

OPEN	LITERAL1
WEP64	LITERAL1
WEP128	LITERAL1
WPA	LITERAL1
WPA2	LITERAL1
DHCP_DISABLED	LITERAL1
DHCP_ENABLED	LITERAL1
AUTOCONNECT_ENABLED	LITERAL1
AUTOCONNECT_DISABLED	LITERAL1

PROFILE_0	LITERAL1
PROFILE_1	LITERAL1
PROFILE_2	LITERAL1
PROFILE_3	LITERAL1
PROFILE_4	LITERAL1
PROFILE_5	LITERAL1
PROFILE_6	LITERAL1
PROFILE_7	LITERAL1
PROFILE_8	LITERAL1
PROFILE_9	LITERAL1
MODE_STATION	LITERAL1
MODE_ACCESS_POINT	LITERAL1
TYPE_SET_EQ	LITERAL1
TYPE_SET_DOT	LITERAL1
TYPE_ASSIGN	LITERAL1
TYPE_READ	LITERAL1
TYPE_ALLOWED	LITERAL1
