getLANAddress	KEYWORD2
showPacket	KEYWORD2
factorySettings	KEYWORD2
setLANAddress	KEYWORD2
getMask	KEYWORD2
setMask	KEYWORD2
receiveMode	KEYWORD2
send	KEYWORD2
sendACK	KEYWORD2
testTransmit	KEYWORD2
continuosWave	KEYWORD2
sendKeepAlive	KEYWORD2
showFirmware	KEYWORD2
setAddressLAN	KEYWORD2
getAddressLAN	KEYWORD2
setFrequency	KEYWORD2
getFrequency	KEYWORD2
setPowerLAN	KEYWORD2
getPowerLAN	KEYWORD2
setMultiPacket	KEYWORD2
getMultiPacket	KEYWORD2
sendLAN	KEYWORD2
receive	KEYWORD2
saveSettings	KEYWORD2
defaultConfiguration	KEYWORD2
parsePacketLAN	KEYWORD2
disableRX	KEYWORD2
getRegion	KEYWORD2
setMacroChannelBitmask	KEYWORD2
getMacroChannelBitmask	KEYWORD2
setMacroChannel	KEYWORD2
getMacroChannel	KEYWORD2
setDownFreqOffset	KEYWORD2
getDownFreqOffset	KEYWORD2
setRegionRC4	KEYWORD2
setRegionRC2	KEYWORD2

_buffer	KEYWORD2
_length	KEYWORD2
_id	KEYWORD2
_power	KEYWORD2
_address	KEYWORD2
_mask	KEYWORD2
_frequency	KEYWORD2
_powerLAN	KEYWORD2
_packet	KEYWORD2
_firmware	KEYWORD2
_version	KEYWORD2
_region	KEYWORD2
_macroChannelBitmask	KEYWORD2
_macroChannel	KEYWORD2
_downFreqOffset	KEYWORD2

WaspSigfox	KEYWORD2

Sigfox	KEYWORD1
SIGFOX_RATE	KEYWORD1
AT_OK	KEYWORD1
AT_ERROR	KEYWORD1
AT_EOL	KEYWORD1
AT_HEADER	KEYWORD1
AT_HEADER_SLASH	KEYWORD1
SIGFOX_LAN_MAX_PAYLOAD	KEYWORD1

SIGFOX_ANSWER_OK	LITERAL1
SIGFOX_ANSWER_ERROR	LITERAL1
SIGFOX_NO_ANSWER	LITERAL1
SIGFOX_CMD_SET	LITERAL1
SIGFOX_CMD_READ	LITERAL1
SIGFOX_CMD_DISPLAY	LITERAL1

SIGFOX_REGION_UNKNOWN	LITERAL1
SIGFOX_REGION_ETSI	LITERAL1
SIGFOX_REGION_FCC	LITERAL1
SIGFOX_REGION_ARIB	LITERAL1
