# BT_Pro keywords #

ENABLE_DATE_AND_TIME	LITERAL1
ENABLE_FRIENDLY_NAME	LITERAL1
BT_BLUEGIGA_RATE	LITERAL1
DEFAULT_MAX_INQUIRY_RESULTS	LITERAL1
RX_BUFFER	LITERAL1
BLOCK_SIZE	LITERAL1
BLOCK_MAC_SIZE	LITERAL1
COMMAND_SIZE	LITERAL1
BT_PRO_PW_1	LITERAL1
BT_PRO_PW_0	LITERAL1
BT_NODE_ID_ADDR	LITERAL1
ERRORSD1	LITERAL1
ERRORSD2	LITERAL1
ERRORSD3	LITERAL1
INQFILE	LITERAL1
TX_POWER_0	LITERAL1
TX_POWER_1	LITERAL1
TX_POWER_2	LITERAL1
TX_POWER_3	LITERAL1
TX_POWER_4	LITERAL1
TX_POWER_5	LITERAL1
TX_POWER_6	LITERAL1
TX_POWER_DEFAULT_WT12	LITERAL1
TX_POWER_MAX_WT12	LITERAL1

WaspBT_Pro	KEYWORD2
numLinesBefore	KEYWORD2
numLinesAfter	KEYWORD2
numberOfDevices	KEYWORD2
commandMode	KEYWORD2
activeConnections	KEYWORD2
linkRSSI	KEYWORD2
friendlyName	KEYWORD2
ON	KEYWORD2
OFF	KEYWORD2
sleep	KEYWORD2
wakeUp	KEYWORD2
reset	KEYWORD2
getNodeID	KEYWORD2
setNodeID	KEYWORD2
getOwnMac	KEYWORD2
getOwnName	KEYWORD2
setOwnName	KEYWORD2
getTemp	KEYWORD2
scanNetwork	KEYWORD2
scanNetworkName	KEYWORD2
scanNetworkLimited	KEYWORD2
scanDevice	KEYWORD2
printInquiry	KEYWORD2
createConnection	KEYWORD2
removeConnection	KEYWORD2
sendData	KEYWORD2
enterCommandMode	KEYWORD2
returnToDataMode	KEYWORD2
checkActiveConnections	KEYWORD2
getRSSI	KEYWORD2
pair	KEYWORD2
removePairedDevices	KEYWORD2
isPaired	KEYWORD2
txPower	KEYWORD2
mac_address	KEYWORD2
CoD	KEYWORD2
devClass	KEYWORD2
commandAnswer	KEYWORD2
theCommand	KEYWORD2
mem_addr	KEYWORD2
identifier	KEYWORD2
lookForAnswer	KEYWORD2
changeInquiryPower	KEYWORD2
parseNames	KEYWORD2
parseBlock	KEYWORD2
waitInquiryAnswer	KEYWORD2
getSetDateID	KEYWORD2
waitScanDeviceAnswer	KEYWORD2
setInquiryTime	KEYWORD2
eraseSDFiles	KEYWORD2
createSDFiles	KEYWORD2
printBuffer	KEYWORD2
printBuffer2	KEYWORD2

BT_Pro	KEYWORD1
